11111111111
100000000s1
10111111111
10000000011
10111111011
10000110011
11110110111
11000110111
11111110111
11110000111
1111f111111
